20 20 
0 0 0 0 0 0 0 0 0 0 0 0 0 0 0 0 0 0 0 0 
0 0 0 0 0 0 0 0 1 1 1 0 0 0 0 0 0 0 0 0 
0 0 1 1 1 1 1 1 1 1 1 1 1 1 0 0 0 0 0 0 
0 0 0 1 1 1 1 1 1 2 1 1 1 1 1 0 0 0 0 0 
0 0 0 0 0 1 1 2 2 2 2 3 2 1 1 0 0 0 0 0 
0 0 0 0 1 1 2 2 2 3 5 3 2 1 1 1 0 0 0 0 
0 0 0 1 1 2 2 2 2 3 5 3 2 2 1 1 1 0 0 0 
0 0 1 1 2 2 3 3 5 2 3 2 2 2 2 1 1 0 0 0 
0 0 1 1 2 3 3 5 3 2 2 2 2 5 3 3 1 1 0 0 
0 1 1 2 3 3 5 3 2 2 2 2 2 2 2 2 1 1 0 0 
0 0 1 1 2 5 3 3 2 2 2 2 2 2 2 1 1 1 0 0 
0 0 0 1 1 2 2 3 2 4 4 2 2 2 1 1 1 0 0 0 
0 0 0 0 1 1 2 2 4 4 4 4 4 1 1 1 0 0 0 0 
0 0 0 0 1 1 2 4 4 4 4 4 1 1 1 1 0 0 0 0 
0 0 0 0 1 1 2 2 2 4 4 4 4 1 2 1 1 0 0 0 
0 0 0 0 0 1 1 3 2 1 4 1 1 1 2 3 1 1 0 0 
0 0 0 0 0 0 1 1 1 1 1 1 0 1 2 2 1 1 0 0 
0 0 0 0 0 0 0 1 1 0 1 0 1 1 1 2 1 1 0 0 
0 0 0 0 0 0 0 0 0 0 0 0 0 1 1 1 1 0 0 0 
0 0 0 0 0 0 0 0 0 0 0 0 0 0 0 0 0 0 0 0 